SO ./textures/sky.png
NO ./textures/pig.png
EA ./textures/east.png
WE ./textures/west.png
C 225,30,0
F 220,100,0

1111111
1000001
1010001
1000001
1111111