SO ./textures/sky.png
NO ./textures/pig.png
C 225,30,0
EA ./textures/east.png
WE ./textures/west.png
F 220,100,0

111111111111111
10001     10001
10001     10001
11111     11111
1             1
1      1      1
1     1N0     1
1      1      1
1             1
11111     11111
10001     10001
10001     10001
111111111111111