NO ./textures/north.png
SO       ./textures/south.png


WE ./textures/west.png

EA ./textures/east.png
F   24, 175, 76

C 16, 203, 212

1111111111111111111111
1000000002100000000001
1000000000000000000001
1000000000000000000001
1100000000000000000001
100000000N000000000001
1100000000000000000001
1000000000000000000001
1000000010101000000001
1111111111111111111111