NO ./textures/north.png
SO       ./textures/south.png


WE ./textures/west.png

EA ./textures/east.png
F   24, 175, 76


C 16, 203, 212

11111111111
10000000001
11000000001
10000000001
10000000001
10000000001
10000N00001
11111111111