NO ./textures/bird.png
SO ./textures/cat.png
WE ./textures/pig.png
EA ./textures/wood.png

F   80,99,52
C   141,181,200

111111111111111111111111111111111111111
10001S10000000000000000000001111 110001
100010100000000000000000000011111111111
100010100000000000000000000011111111111
100010100000000000000000000011111111111
10001010000000000000000000001111111111111111111111111111111111111111
100010100000000000000000000011111111111
100010100000000000000000000011111111111
100010100000000000100000000011111111111
100010100000000001 100000000011111111111
100010100000000000100000000011111111111
100010100000000000000000000011111111111
100010100000000000000000000011111111111
100000000000011110000000000011111111111
11111111111111111111111111111