NO ./textures/swaston.png
SO       ./textures/swaston.png
WE ./textures/swaston.png      

EA ./textures/swaston.png

F   0, 0, 0 
C   255, 255, 255

11111
10001
10N01
10001
11111

