SO ./textures/south.png


NO ./textures/north.png
F   24, 175, 76
EA ./textures/east.png
WE ./textures/west.png

C   16, 203, 212


111111111111
100000000001
100010011101
100100011101
1010000N1101
100000000001
111111111111