SO ./textures/south.png
NO ./textures/north.png
EA ./textures/east.png
WE ./textures/west.png
C   16,203,212
F   24,175,76




1111111
1110111
1110111
1110111
1110111
1110111
1110111
1110111
1110111
1110111
1110111
1110111
1110111
1110111
1110111
1110111
1110111
1110111
1110111
1110111
1110111
1110111
1110111
1110111
1110111
1110111
1110111
1110111
1110111
1110111
1110111
1110111
1110111
1110111
1110111
1110111
1110111
1000001
100N001
1000001
1111111